人型生物=Humanoid
偷窃=Pick Pocket
菊花茶=_not_exist_
鬼魅攻击=Ghostly Strike
出血=_not_exist_
背刺=Backstab
躲闪=Evasion
伺机待发=_not_exist_
低吼=_not_exist_
挫志咆哮=_not_exist_
槌击=_not_exist_
愤怒=_not_exist_
愈合=_not_exist_
治疗之触=_not_exist_
元素生物=Elemental
毒蛇钉刺=Serpent Sting
毒蝎钉刺=Scorpid Sting
_no_key_=Viper Sting
摔绊=Wing Clip
猛禽一击=Raptor Strike
猎人印记=Hunter\\'s Mark
奥术射击=Arcane Shot
邪恶攻击=Sinister Strike
凿击=Gouge
消失=Vanish
潜行=Stealth
切割=Slice and Dice
疾跑=Sprint
治疗药水=Healing Potion
绞喉=Garrote
伏击=Ambush
_no_key_=Track Beasts
灵猴守护=Aspect of the Monkey
_no_key_=Shadowmeld
绷带=Bandage
雄鹰守护=Aspect of the Hawk
猎豹守护=Aspect of the Cheetah
复活宠物=Revive Pet
_no_key_=Tame Beast
召唤宠物=Call Pet
解散宠物=Dismiss Pet
_no_key_=Feed Pet
治疗宠物=Mend Pet
震荡射击=Concussive Shot
_no_key_=Distracting Shot
_no_key_=Track Humanoids
机械生物=Mechanical
猫鼬撕咬=Mongoose Bite
假死=Feign Death
冰冻陷阱=Freezing Trap
冰霜陷阱=Frost Trap
_no_key_=Trueshot
_no_key_=Intimidation